7,1,7,7,7,7,7,7,7,7
1,0,1,7,7,7,7,7,7,7
7,1,7,7,7,7,7,7,7,7
7,3,7,7,7,7,7,7,7,7
7,1,7,7,7,7,7,7,7,7
7,1,7,7,7,7,7,7,7,7
7,1,7,7,7,7,7,7,7,7
1,1,1,7,7,7,7,7,7,7
1,3,1,7,7,7,7,7,7,7
1,1,1,7,7,7,7,7,7,7
